#####
#@ $.#
#    #
# .$ #
#####
