######  ### 
#..  # ##@##
#    ###   #
#..        #
#    # #   #
#..### #   #
#### $ #$  #
   #  $# $ #
   # $  $  #
   #  ##   #
   #########