#########
#   #   #
# $##$  #
#  # .  #
# .@$.  #
#  # #  #
# .$ $  #
#   .   #
#########