       ##### 
 #######   ##
## # @##    #
#    $      #
#  $  ###   #
### #####$###
# $  ###   # 
#     $    # 
#    ###...# 
#  $ # #...# 
#  ### ##### 
####  