    #######
   ##     ##
  ## $$  . #
 ##    ##  #
 # .@$  . ##
 #  $ #   #
 #.$  ##  #
 ##  . ####
  ########