     ##########
    ## .   .  #
   ##  $#  $ .#
  ##    # $  ##
  #  # @$  . #
  #  ##  # $ #
  #.   $    ##
  ##  .   ### 
   ######## 
