    #######
   ##  .  ##
  ##  $  . #
 ##  $ ##  #
 # .@$  .$##
 #  $ #   #
 #.$  ##  #
 ##  . #  #
  #########