        ######## 
        #     @# 
        #  #$ ## 
        # $  $#  
        ##  $ #  
#########   # ###
#...   ## $  $  #
##              #
#...   ##########
########         
