    #######
    #  .  #
  ### $$  #
 ##  .    #
 # .$@$. ##
 ###      #
 #  $  #### 
 #  .  #   
 #######   
