    ########
   ##  .  ##
  ## $$#  .#
 ##   $   $#
 # .##  @ .#
 #   $  #  #
 #.    #   #
 ##    #####
  ###### 