    ########
   ##     ##
  ##  $#  .#
 ##  $   $ #
 # .  @$ . #
 #  ##  #  #
 #.  ##$  ##
 ##  .    ##
  #########  
