############  
#**  #     ###
#*.  #       #
#.+  # ####  #
#.*   $  ##  #
#**  # #    ##
###### ##    #
  #  $$ $    #
  #    #     #
  ############
